{
  "id": "armor-arena",
  "displayName": "Armor Arena",
  "heroStart": {
    "column": 1,
    "row": 1
  },
  "tiles": [
    [50, 50, 50, 50, 50, 50, 50, 50, 50, 50, 50, 50, 50, 50],
    [50, 3, 3, 3, 3, 3, 3, 3, 3, 3, 3, 3, 3, 50],
    [50, 3, 50, 3, 3, 3, 50, 50, 3, 3, 3, 50, 3, 50],
    [50, 3, 3, 3, 3, 3, 3, 3, 3, 3, 3, 3, 3, 50],
    [50, 3, 3, 3, 50, 50, 3, 3, 50, 50, 3, 3, 3, 50],
    [50, 3, 50, 3, 3, 3, 3, 3, 3, 3, 3, 50, 3, 50],
    [50, 3, 3, 3, 3, 3, 3, 3, 3, 3, 3, 3, 3, 50],
    [50, 3, 3, 3, 50, 3, 3, 3, 3, 50, 3, 3, 3, 50],
    [50, 3, 50, 3, 3, 3, 3, 3, 3, 3, 3, 50, 3, 50],
    [50, 3, 3, 3, 3, 3, 3, 3, 3, 3, 3, 3, 3, 50],
    [50, 3, 3, 3, 3, 3, 3, 3, 3, 3, 3, 999, 3, 50],
    [50, 50, 50, 50, 50, 50, 50, 50, 50, 50, 50, 50, 50, 50]
  ],
  "items": [
    [0, 0, 0, 0, 0, 0, 0, 0, 0, 0, 0, 0, 0, 0],
    [0, 0, 0, 0, 0, 0, 0, 0, 0, 0, 0, 0, 0, 0],
    [0, 0, 0, 0, 0, 350, 0, 0, 0, 0, 0, 0, 0, 0],
    [0, 160, 0, 0, 0, 0, 0, 0, 0, 0, 0, 0, 0, 0],
    [0, 0, 0, 0, 0, 0, 0, 0, 0, 0, 0, 0, 0, 0],
    [0, 0, 0, 200, 0, 0, 0, 0, 0, 0, 0, 0, 0, 0],
    [0, 0, 0, 0, 0, 0, 0, 0, 0, 0, 0, 0, 160, 0],
    [0, 0, 0, 0, 0, 0, 0, 0, 0, 0, 0, 0, 0, 0],
    [0, 0, 0, 0, 0, 0, 0, 0, 0, 0, 0, 0, 0, 0],
    [0, 0, 0, 0, 0, 0, 0, 0, 0, 0, 350, 0, 0, 0],
    [0, 0, 0, 0, 0, 0, 0, 0, 0, 300, 0, 0, 0, 0],
    [0, 0, 0, 0, 0, 0, 0, 0, 0, 0, 0, 0, 0, 0]
  ],
  "enemies": [
    [0, 0, 0, 0, 0, 0, 0, 0, 0, 0, 0, 0, 0, 0],
    [0, 0, 0, 0, 0, 0, 0, 0, 0, 0, 0, 0, 0, 0],
    [0, 0, 0, 0, 0, 0, 0, 0, 500, 0, 0, 0, 0, 0],
    [0, 0, 0, 0, 0, 0, 0, 0, 0, 0, 0, 0, 0, 0],
    [0, 0, 0, 0, 0, 0, 0, 0, 0, 0, 0, 0, 0, 0],
    [0, 0, 0, 0, 0, 0, 0, 0, 0, 0, 0, 0, 0, 0],
    [0, 510, 0, 0, 0, 0, 0, 0, 0, 0, 0, 0, 0, 0],
    [0, 0, 0, 0, 0, 0, 530, 0, 0, 0, 0, 0, 0, 0],
    [0, 0, 0, 0, 0, 0, 0, 0, 0, 0, 0, 0, 0, 0],
    [0, 0, 0, 520, 0, 0, 0, 0, 0, 0, 0, 0, 0, 0],
    [0, 0, 0, 0, 0, 0, 0, 0, 0, 0, 0, 0, 0, 0],
    [0, 0, 0, 0, 0, 0, 0, 0, 0, 0, 0, 0, 0, 0]
  ]
}
