{
  "id": "forest-json",
  "displayName": "Forest (JSON)",
  "heroStart": {
    "column": 1,
    "row": 1
  },
  "tiles": [
    [50, 50, 50, 50, 50, 50, 50, 50, 50, 50, 50, 50],
    [50, 4, 4, 5, 4, 4, 4, 4, 4, 5, 4, 50],
    [50, 4, 50, 50, 4, 50, 50, 50, 4, 50, 4, 50],
    [50, 5, 4, 3, 3, 3, 3, 4, 4, 50, 4, 50],
    [50, 4, 4, 3, 50, 50, 3, 4, 3, 3, 4, 50],
    [50, 4, 50, 3, 3, 900, 3, 4, 50, 3, 4, 50],
    [50, 4, 50, 3, 50, 50, 3, 4, 50, 3, 4, 50],
    [50, 4, 3, 3, 3, 3, 3, 4, 900, 3, 4, 50],
    [50, 4, 3, 50, 50, 75, 50, 50, 50, 3, 4, 50],
    [50, 4, 3, 3, 3, 3, 3, 3, 3, 3, 4, 50],
    [50, 4, 4, 4, 4, 4, 4, 4, 4, 999, 4, 50],
    [50, 50, 50, 50, 50, 50, 50, 50, 50, 50, 50, 50]
  ],
  "items": [
    [0, 0, 0, 0, 0, 0, 0, 0, 0, 0, 0, 0],
    [0, 160, 0, 0, 0, 0, 0, 0, 0, 0, 0, 0],
    [0, 0, 0, 0, 0, 0, 0, 0, 0, 0, 300, 0],
    [0, 0, 0, 200, 0, 0, 0, 0, 0, 0, 0, 0],
    [0, 0, 0, 0, 0, 0, 0, 0, 0, 0, 0, 0],
    [0, 0, 0, 0, 0, 0, 0, 0, 0, 230, 0, 0],
    [0, 0, 0, 0, 0, 0, 0, 0, 0, 0, 0, 0],
    [0, 0, 0, 0, 0, 0, 0, 160, 0, 0, 0, 0],
    [0, 0, 0, 0, 0, 0, 0, 0, 0, 0, 0, 0],
    [0, 0, 0, 0, 0, 0, 0, 0, 0, 0, 0, 0],
    [0, 0, 0, 0, 0, 0, 0, 170, 0, 0, 0, 0],
    [0, 0, 0, 0, 0, 0, 0, 0, 0, 0, 0, 0]
  ],
  "enemies": [
    [0, 0, 0, 0, 0, 0, 0, 0, 0, 0, 0, 0],
    [0, 0, 0, 0, 0, 0, 0, 0, 0, 0, 0, 0],
    [0, 0, 0, 0, 0, 0, 0, 0, 0, 0, 0, 0],
    [0, 0, 500, 0, 0, 0, 0, 0, 0, 0, 0, 0],
    [0, 0, 0, 0, 0, 0, 0, 0, 0, 0, 0, 0],
    [0, 0, 0, 0, 0, 0, 0, 0, 0, 0, 0, 0],
    [0, 0, 0, 0, 0, 0, 0, 0, 0, 0, 510, 0],
    [0, 0, 0, 0, 0, 0, 0, 0, 0, 0, 0, 0],
    [0, 0, 0, 0, 0, 0, 0, 0, 0, 530, 0, 0],
    [0, 0, 0, 0, 0, 0, 0, 0, 0, 0, 0, 0],
    [0, 0, 0, 0, 0, 0, 0, 0, 520, 0, 0, 0],
    [0, 0, 0, 0, 0, 0, 0, 0, 0, 0, 0, 0]
  ]
}
