{
  "id": "magical-tower",
  "displayName": "Magical Tower",
  "heroStart": {
    "column": 1,
    "row": 1
  },
  "tiles": [
    [50, 50, 50, 50, 50, 50, 50, 50, 50, 50, 50, 50, 50, 50, 50],
    [50, 3, 3, 3, 3, 3, 3, 3, 3, 3, 3, 3, 3, 3, 50],
    [50, 3, 310, 50, 50, 50, 50, 50, 50, 50, 50, 311, 3, 3, 50],
    [50, 3, 50, 3, 3, 3, 3, 3, 3, 3, 3, 50, 3, 3, 50],
    [50, 3, 50, 3, 313, 3, 3, 312, 3, 3, 313, 50, 3, 3, 50],
    [50, 3, 50, 3, 3, 3, 3, 3, 3, 3, 3, 50, 3, 3, 50],
    [50, 3, 50, 50, 50, 314, 50, 50, 314, 50, 50, 50, 3, 3, 50],
    [50, 3, 3, 3, 3, 3, 3, 3, 3, 3, 3, 3, 3, 3, 50],
    [50, 3, 311, 3, 3, 3, 900, 3, 3, 3, 310, 3, 3, 3, 50],
    [50, 3, 3, 3, 50, 50, 50, 50, 50, 3, 3, 3, 3, 3, 50],
    [50, 50, 50, 3, 3, 313, 3, 312, 3, 3, 50, 50, 50, 50, 50],
    [50, 3, 3, 3, 3, 3, 3, 3, 3, 3, 3, 3, 3, 3, 50],
    [50, 3, 310, 50, 50, 50, 50, 50, 50, 50, 311, 3, 3, 900, 50],
    [50, 3, 50, 3, 3, 3, 3, 3, 3, 3, 50, 3, 3, 3, 50],
    [50, 3, 50, 3, 314, 3, 3, 3, 314, 3, 50, 3, 999, 3, 50],
    [50, 50, 50, 50, 50, 50, 50, 50, 50, 50, 50, 50, 50, 50, 50]
  ],
  "items": [
    [0, 0, 0, 0, 0, 0, 0, 0, 0, 0, 0, 0, 0, 0, 0],
    [0, 160, 0, 0, 0, 0, 0, 0, 0, 0, 0, 0, 0, 0, 0],
    [0, 0, 0, 0, 0, 0, 0, 0, 0, 0, 0, 0, 0, 0, 0],
    [0, 0, 0, 0, 0, 0, 0, 0, 0, 0, 0, 0, 0, 0, 0],
    [0, 0, 0, 0, 0, 0, 0, 0, 0, 300, 0, 0, 0, 0, 0],
    [0, 0, 0, 0, 0, 0, 240, 0, 0, 0, 0, 0, 0, 0, 0],
    [0, 0, 0, 0, 0, 0, 0, 0, 0, 0, 0, 0, 0, 0, 0],
    [0, 0, 0, 0, 0, 160, 0, 160, 0, 0, 0, 0, 0, 0, 0],
    [0, 0, 0, 0, 0, 0, 0, 0, 0, 0, 0, 0, 160, 0, 0],
    [0, 0, 0, 0, 0, 0, 0, 0, 0, 0, 0, 0, 0, 0, 0],
    [0, 0, 0, 0, 0, 0, 0, 0, 0, 0, 0, 0, 0, 0, 0],
    [0, 0, 0, 0, 0, 0, 160, 0, 0, 0, 0, 0, 0, 0, 0],
    [0, 0, 0, 0, 0, 0, 0, 0, 0, 0, 0, 0, 0, 0, 0],
    [0, 0, 0, 0, 0, 0, 0, 240, 0, 0, 0, 0, 0, 0, 0],
    [0, 0, 0, 0, 0, 0, 0, 0, 0, 0, 0, 0, 0, 0, 0],
    [0, 0, 0, 0, 0, 0, 0, 0, 0, 0, 0, 0, 0, 0, 0]
  ],
  "enemies": [
    [0, 0, 0, 0, 0, 0, 0, 0, 0, 0, 0, 0, 0, 0, 0],
    [0, 0, 0, 0, 0, 0, 0, 0, 0, 0, 0, 0, 0, 0, 0],
    [0, 0, 0, 0, 0, 0, 0, 0, 0, 0, 0, 0, 0, 0, 0],
    [0, 0, 0, 0, 500, 0, 0, 0, 0, 520, 0, 0, 0, 0, 0],
    [0, 0, 0, 0, 0, 0, 0, 0, 0, 0, 0, 0, 0, 0, 0],
    [0, 0, 0, 0, 0, 0, 0, 0, 0, 0, 0, 0, 510, 0, 0],
    [0, 0, 0, 0, 0, 0, 0, 0, 0, 0, 0, 0, 0, 0, 0],
    [0, 0, 0, 0, 0, 0, 0, 0, 0, 0, 0, 0, 0, 0, 0],
    [0, 0, 0, 0, 0, 0, 0, 0, 0, 0, 0, 500, 0, 0, 0],
    [0, 0, 0, 0, 0, 0, 0, 0, 0, 0, 0, 0, 0, 0, 0],
    [0, 0, 0, 510, 0, 0, 0, 0, 0, 520, 0, 0, 0, 0, 0],
    [0, 0, 0, 0, 0, 0, 0, 0, 0, 0, 0, 0, 0, 0, 0],
    [0, 0, 0, 0, 0, 0, 0, 0, 0, 0, 0, 0, 0, 0, 0],
    [0, 0, 0, 0, 0, 530, 0, 0, 530, 0, 0, 0, 0, 0, 0],
    [0, 0, 0, 0, 0, 0, 0, 0, 0, 0, 0, 0, 0, 0, 0],
    [0, 0, 0, 0, 0, 0, 0, 0, 0, 0, 0, 0, 0, 0, 0]
  ]
}
