{
  "id": "summoner-demo",
  "displayName": "Summoner Demo",
  "heroStart": {
    "column": 1,
    "row": 1
  },
  "tiles": [
    [50, 50, 50, 50, 50, 50, 50, 50, 50, 50, 50, 50],
    [50, 4, 4, 4, 4, 4, 4, 4, 4, 4, 4, 50],
    [50, 4, 4, 4, 4, 4, 4, 4, 4, 4, 4, 50],
    [50, 4, 4, 4, 4, 4, 4, 4, 4, 4, 4, 50],
    [50, 4, 4, 4, 4, 4, 4, 4, 4, 4, 4, 50],
    [50, 4, 4, 4, 4, 4, 4, 4, 4, 4, 4, 50],
    [50, 4, 4, 4, 4, 4, 4, 4, 4, 4, 4, 50],
    [50, 4, 4, 4, 4, 4, 4, 4, 4, 4, 4, 50],
    [50, 4, 4, 4, 4, 4, 4, 4, 4, 4, 4, 50],
    [50, 4, 4, 4, 4, 4, 4, 4, 4, 4, 4, 50],
    [50, 4, 4, 4, 4, 4, 4, 4, 4, 4, 999, 50],
    [50, 50, 50, 50, 50, 50, 50, 50, 50, 50, 50, 50]
  ],
  "items": [
    [0, 0, 0, 0, 0, 0, 0, 0, 0, 0, 0, 0],
    [0, 242, 0, 0, 0, 0, 0, 0, 0, 0, 0, 0],
    [0, 0, 0, 0, 0, 0, 0, 0, 0, 0, 0, 0],
    [0, 0, 0, 0, 0, 0, 0, 0, 0, 0, 0, 0],
    [0, 0, 0, 0, 0, 0, 0, 0, 0, 0, 0, 0],
    [0, 0, 0, 0, 0, 0, 0, 0, 0, 0, 0, 0],
    [0, 0, 0, 0, 0, 0, 0, 0, 0, 0, 0, 0],
    [0, 0, 0, 0, 0, 0, 0, 0, 0, 0, 0, 0],
    [0, 0, 0, 0, 0, 0, 0, 0, 0, 0, 0, 0],
    [0, 0, 0, 0, 0, 0, 0, 0, 0, 0, 0, 0],
    [0, 0, 0, 0, 0, 0, 0, 0, 0, 0, 0, 0],
    [0, 0, 0, 0, 0, 0, 0, 0, 0, 0, 0, 0]
  ],
  "enemies": [
    [0, 0, 0, 0, 0, 0, 0, 0, 0, 0, 0, 0],
    [0, 0, 0, 0, 0, 0, 0, 0, 0, 0, 0, 0],
    [0, 0, 0, 0, 0, 0, 0, 0, 0, 0, 0, 0],
    [0, 0, 0, 0, 0, 0, 0, 0, 0, 0, 0, 0],
    [0, 0, 0, 0, 0, 0, 0, 0, 0, 0, 0, 0],
    [0, 0, 0, 0, 0, 540, 0, 0, 0, 0, 0, 0],
    [0, 0, 0, 0, 0, 0, 0, 0, 0, 0, 0, 0],
    [0, 0, 0, 0, 0, 0, 0, 0, 0, 0, 0, 0],
    [0, 0, 0, 0, 0, 0, 0, 0, 0, 0, 0, 0],
    [0, 0, 0, 0, 0, 0, 0, 0, 0, 0, 0, 0],
    [0, 0, 0, 0, 0, 0, 0, 0, 0, 0, 0, 0],
    [0, 0, 0, 0, 0, 0, 0, 0, 0, 0, 0, 0]
  ]
}
